DATA
name:Dificuldade - Parte I
img_preview:iVBORw0KGgoAAAANSUhEUgAAAtkAAAGrCAIAAACaLRyeAAAOjElEQVR42u3c263rurZFQebEnJx/BnIA8odsieZ4VEf9Xpw19aDaBYw9hpmZmZmZmZmZmZmZmZmZmZmZmZmZmZmZmZmZmZmZmZmZmZmZmZmZmZmZmZmZmZmZmZmZmZmZmZmZmZmZmZmZmZmZmZmZmZmZmZmZmZmZmZmZmZmZmZmZmZmZmZmZmZmZmZmZmZmZmZmZmZmZmZmZmZmZmZmZmZmZmZmZmZmZmZmZmZmZmZmZmZmZmZmZmZmZmZmZmZmZmZmZmZmZmZmZmZmZmZmZmZmZmZlV2vE6AIDHaQwtAgBaRIsAgBYxLQIAWkSLQBFzjjOXBdAiWgS0CKBFtAhoEQAtokVAiwBaRItA2ezQIjIOtIgWAS2iRUCLaBHQIj6oWgS0iBYBLaJFQItoEfDtBNAiWgS0CKBFtAhoEQAtokVAiwBaRIuAFsFvgdEipkVAi2gR0CJaBLQIWgQtYloEtIgWAS2iRUCL4CKjRUyLgM+kiwxaRIuAzyQuMlrEtAj4TLrIoEW0CH6u+BhfRC0CWkSLgBbBlQctokXQIr6IWgS0iBYBLYIrDxpDi6BvIHQBo0VMi6BFQIugRbQIaBG0CFpEi4AWAS2CFtEiAKBFtAgAoEW0CABoES0CAGgRLQIAWkSLAABaRIsAgBbRIgCAFtEiAKBFtAgAoEW0CABoES0CAGgRLQIAWkSLAABaRIsAgBbRIgCAFtEiAKBFtAgAaBHTIgCgRbQIAGgR0yIAoEW0CABoEdMiAKBFtAgAaBHTIgCgRbQIAGgRLQIAaBEtAgBaRIsA/Muc48xlQYtoEQAtAlpEiwBaBLSIFgHQIqBFtAigRUCLaBEALQJaRIsAWgS0iBYB0CKgRbQIoEWUEFpEiwBoEdAiWgTQIloELaJFALQIaBEtAqE+Px//hwJ+/DrXQJZ7hBbRIqBFtIgW8e6gRbQIaBEtokXQIloEtIgW0SKgRbQI+PjV+ammfxJaxLxgaBEt4sOvRdAiWgS0iBbxT0KLaBHQIlrEh1+LoEW0CNW+8Z2/NNf/h1b8k67fDv+1MT9oRYtoEbSIFtEiWgQtokVAi2gRLaJF0CJaBC2iRbSIFkGLaBFI+UnTIqH+1+v9UFSLoEW0CFpEi2gRLYIW0SJoES2iRbSIFkGLaBG0iBbRIloELaJF8OPTan9m6ha5eeO0iLcDLaJFcNpqES2iRdAiWgS0iBbRIloELaJFcNpqES2iRdAiWgQ/Pi1+sO5tkRVXfu//eeffhGoRtIgWQYtoES2iRdAiWgQtokW0iBbRImgRLYIW0SJaRIugRbQIfl7n+7HnHt38mWrAOPMsoUW0CFpEi2gRz6cWQYtoEZz1WkSLeJbQIloELaJFtIjnU4ugRbQIssP3o8LPkztfee+dFjEtokXwRdQiXkO0iBbBIahFtIgWQYuYFtEiaBEt4jVEi2gRnHdaxJX3H9NDi5gW0SKup0vnyvsz0SJaBC3iU+HK+zPRIlrE46JFXE+XzpX3Z6JFtAiONtfTlfdnokW0CI421xNX3p+JFtEiONpcT1fen4kW0SI42lxPXHl/JlpEizis/UzVp8KT7G9Hi2gRnGJaBE+yvx0tokWc4E4xLeJJ9rejRbQITjEtgifZ344W0SI+k7jILrILghbRIjiwXGRcZBcELaJFHFi4yC6yC4IW0SI4sFxkXGQXBC2iRfzADV8FF9kFQYtoEbSIrwIusguCFtEiWgRfBRfZBUGLaBG0iK+Ci+wiuyBoES3ibEIFerxdELSIFsHZpEVcZNfTBdEipkWcTWgRj7cLghbRIjibtIiL7IK4IFrEtIizCbdD27lKaBEtgo+f2+Er6yq5SlrEtIiPH26Hr6yrhBbRIk5wx5Db4SvrKrlKWsS0iI8fy25Hk8+PJ9mlQ4toEccQWsST7NKhRbQIjiG3Q4t4kl06tIgWcQyhRTzJLh1aRIvgGPLTwrj/Q55khwBaRIvgGNIiWgSXTouYFnEMoUU8yQ4BtIgWwTGkRbSIp86l0yKmRap950j6qbj+hNzkSdYiaBEt4sRxgvtUaBG0iBYxLaJF0CKeZC2CFtEiThzHkE+FFvGAuXRaxLSIE0exuXEuiOuJFtEiThy0iCfZ9XQ9tYgWwYmjRdw4F8T1RItoESeOq6RFPMmupyujRbQIThw/5nXj/EzVA4YW0SJOHN85LeIeORnQIloEJ44W0SJaxAOGFtEiThzfOTfOPXIyoEW0CE6cnp+0zt9jn0kXGS2iRZw4WsQ/3kPrZECLaBGcOFpEi/hMushoES3ixNEi/vEeWicDWkSL4MTx5S57N1P/lNjnHC2iRdAiWkSL+HeCFtEivl4+ae6mFtEiaBEtghbRIm6cfydoES2Cr4IW6fUXaRG0iBZBi2gRLeIfD1pEi6BFfPy0iBZBi2gRtIgW8Rf5x4MW0SLIDh8/LeIHrWgRLYIW0SL+Is8naBEtgrPel1uLaBG0iBZBi2gRf5HnEy1iWgTHuqvU7BZ7aNEiWgRfWVdJi2gR0CJaBB8qV0mLeGjRIloEX1lXyT9ei6BFTIvgBO946fz36DzJaBEtghPcpdMibgdaxLQITnAtokU8yWgRLYIT3KXTIp5ktIhpEXyotIj/Hh1oES2CFvHx8z32t6NFTIugRbSI2wFaRIugRXz8fI/97WgR0yK+nQ5rPPOgRbQIzmXwzKNFtAjOZecynnnQIloE5zJ45tEiWgQ/UwUtAlpEi6BFQIugRbQIWgS0CGgRLYIWAS2CFtEiOILBiwBaRIvgCAYvAlpEi+AIBi8CaBEtgiMYvAhoES2CIxi8CKBFtAiOYPAioEW0CI5g8CKAFtEiOILBi4AW0SLEPG0dwaBF0CJaBC0CWgQtYlpEiziC8XZ4EdAiWgQtAloELWJaxGkL3g6ljhbRImgR0CJoEdMiWgS0iFcGLaJF0CKgRdAiWgR8afDYeELQIloEtAhaBC2iRUCLoEVAi2gR0CJoEbSIFgEfFTw2oEW0CPio4LFBi2gR8FHBYwNaRIuAjwoeG7SIFgE/U0WL4CJrES2Co02L4DPpImsRLQJaBJ9JXGQtokVwtGkRfCZdZC2iRUB24DOJi6xFtAhaBHwmXWQtokVAi+AziYusRbQIWgR8Jl1kLaJFQHbgM4kWMS2CFgGfSRdZi2gR0CL4TLrIWsS0CFoEfCZdZC2iRcCBhafORdYipkVwYIGnzkXWIloEHFh46lxkLWJaBAcWnjpPnYusRbQIziY/U/X58e/0MGgRLQJaBC3iqXORtYgWQYv4Kvj8+Hd6GLSIFgEtghZxB11kLaJFcDbhFvt3uu9aRIuAAwstguupRbQIDizcYv9O912LaBFwYKFFcD21iBbBz1TxTcJ91yJaBLQIvkm471pEi6BF8E3CfdciWgS0CL5JuO9aRIvgbEKD4n3XIloEnE1oEbzvWkSL4GxCi+B91yJaBJxNaBH33S3WIloEZxMeBtxiLaJFwNmEh8Etdou1iBbB2YSHAbdYi2gRcDbhYXCLtYhpEfxcER8q3E0tokXQIg4sT4iHwd3UIqZF0CL4euFuahEtghbx1HlCPAzuphYxLYKzCU8I7qYW0SI4m/CEuCzuphYxjw7OJjwhuJtaRIvgbMITgrupRbQIOJvwhOBuahEtgrMJTwjuphbRIuBswhOCu6lFtAjOJjwhuJtaRIuAswlPiBvnP2OoRbQIvjR4QtAiWkSLgC8NnhA3TotoES2CLw2eELSIFtEinmZ8afCEuHGujBbRIjiw8ITgxmkRLaJFcGDhCXHj0CJaBAcWnhDcOC2iRTziuJt4Qtw4tIgWwYGFJwQ3TotoEY+4A8vdxBPixqFFtAjuJp4Q3DgtokX8oNWB5cbhCXHjtIhpERxYeEJw47SIFtEiDizwhLhxWsS0CA4sPCG4cVpEiwgU8EnzFrtHWsS0COA7h3ukRbSIFgHfOW+xe6RFTIsAvnO4R1pEi3hDwHcO90iLaBFvCOAtxj3SIlrEGwK+c7hHWkSLeEMAb7F75B5pES3iB63gO4d7pEW0iBYBfOfcI/dIi2gRLQK+c7hHWkSLaBHAd849Qou0bxGvDfjO4f/B0yJaxNEGeGG1CFpEizjawAuLFtEiWsTRBnhhtQhaRIs42sALi+zQIlrE0QZ4YbUIWkSLeJfAC4sW0SJaxNEGeGG1CFpEi3jBQIvgysf4ymgMLeKtA19EXHktokW0COCL6MprEdMi3jrwRXTlXXktokUECjjWvYbOul4PrcbQIt5P0CJaxEXWIlrE+wloEWedFjEt4v0ELeKsQ4toEYcggGNNi5gW8dICjjW0iBbx0gI41rSIaREvLeBYQ4toET/yAnBY1b3yGkOLeL0BhxVaRIt4vQEcVlrEtIjXG3BYoUW0SO4nz0EAyA5X/lsaQ4toEcAXES2iRbQIgBbRIqZFtAigRdAiWiT3f5ZHtQBOBtmhRbSIEwdwMqBFtIgWceIATgYtokW0iBMHcDKgRbSIX2kBvnNOMNmhRbQIgBZBi2gRLQL4+DnBtIgW0SIAWsTt0CJaRKAA4DOhRbQIAFpEi2gRLQKAFjEtAoAW0SJaRKAA8PM5n/rw1xhaBAAtokW0iBYBQIuYFgFAi2gRLSJQAMREr9NbY2gRALSIFtEiWgRAi2gR0yIAaBEtokUECgC9aAwtokUA0CJaRIsAoEVMi2gRALSIFgEALWJaBAC0iBYBAC1iWgQAtIgWAQAtYp4VANAiWgQAtIgWAQC0iBYBAC2iRQAALaJFAECLaBEAQItoEQDQIloEANAiWgQAtIgWAQC0iBYBAC2iRQAALaJFAECLaBEAQIuYmZmZmZmZmZmZmZmZmZmZmZmZmZmZmZmZmZmZmZmZmZmZmZmZmZmZmZmZmZmZmZmZmZmZmZmZmZmZmZmZmZmZmZmZmZmZmZmZmZmZmZmZmZmZmZmZmZmZmZmZmZmZmZmZmZmZmZmZmZmZmZmZmZmZmZnF3htfPPF0Y5xEdQAAAABJRU5ErkJggg==
sleep_timer:120
rushing_speed:60
size_required:60
food_amount:30
map_size:90
map_color:255;102;255
snake_color:0;0;204
wall_color:51;51;0
food_color:0;255;0


MAP
..........................................................................................
.......................................:..................................................
......................................::..............:...................................
......................................:...................................................
......................................:...............::..................................
......................................:................:..................................
.............................:::::...:.................:..................................
.................................:::::::::::::::::::::::::::::::..........................
..........................................................................................
..........................................................................................
..........................................................................................
..........................................................................................
..........................................................................................
..........................................................................................
..........................................................................................
.......................................................:..................................
.......................................................:..................................
.......................................................:.....:............................
....................................:....::......:.....:.....::...........................
....................................:.....::....:......:......:...........................
............................::......:....:.:...:::.....:......::..........................
..........................:::.......:....:.:...:.:.....:.......:..........................
.........................::.........:....:.:..::.:.....:.......::.........................
.......................:::..........:....:::..:..:.....:........:.........................
......................::............:.....::..:.::....::........:.........................
.....................::.............:.........:::.....:.........::........................
....................::..............:.................:..........:........................
....................:...............:.................:..........:........................
...................::...............:................::..........::.......................
...................:................:................:............:.......................
..................::................:................:............:.......................
..................:.................::...............:............:.......................
..................:..................:..............::............::......................
..................:..................:...::.........:..............:......................
..................:..................::...::...:....:..............:......................
.................::...................:....:::::...::..............:......................
.................:.............::.....:............:...............:......................
.................:............::......:...........::...............:......................
.................:...........::.......::..........:................:......................
.................:..........::.........:.........::......::...............................
...........................::..........:.........:........:...............................
..........................::...........:.........:........::..............................
.........................::............::.......::.........:..............................
.........................:..............:......::..........:..............................
........................::..............:......:...........:..............................
........................:...................................:.............................
.......................::...................................:.............................
.......................:....................................:.............................
.......................:....................................:.............................
......................::....................................:.............................
......................:.....................................::............................
..................................::.........................:............................
..................................:..........................:............................
.................................::..........................:................:...........
................................::...........................:................:...........
...............................::............................:................:...........
...............................:.............................:................:...........
..............................::.....................:.......:................:...........
..............................:......................:.......:...............:............
.............................::......................:.......................:............
.............................:.......................::......................:............
.............................:........................:......................:............
............................::........................:.....................:.............
............................:.........................:.....................:.............
............................:.........................:.....................:.............
............................:.........................:....................::.............
.....::.....................:.........................:....................:..............
......:.....................:.........................:....................:..............
......::....................:.........................:....................:..............
.......::.............................................:...................:...............
........:.............................................:...................:...............
........::............................................:...................:...............
.........:............................................:..................::...............
.........:............................................:.................::................
.........::...........................................:.................:..............::.
..........::..........................................:...............::...............:..
...........:..........................................................:................:..
...........::.......................................................::................::..
............:::....................................................::................::...
.....:........:::...............................................:::.................::....
.....::.........................................................:..................::.....
......::.........................................................................::.......
.......::......................................................................:::........
........::..................................................................::::..........
.........::...............................................................................
..........................................................................................
..........................................................................................
..........................................................................................
..........................................................................................
..........................................................................................
